EXPORTS
    CreateDirect3D11DeviceFromDXGIDevice = geecore_CreateDirect3D11DeviceFromDXGIDevice
    CreateDirect3D11SurfaceFromDXGISurface = geecore_CreateDirect3D11SurfaceFromDXGISurface
    D3D11CoreCreateDevice = geecore_D3D11CoreCreateDevice
    D3D11CoreCreateLayeredDevice = geecore_D3D11CoreCreateLayeredDevice
    D3D11CoreGetLayeredDeviceSize = geecore_D3D11CoreGetLayeredDeviceSize
    D3D11CoreRegisterLayers = geecore_D3D11CoreRegisterLayers
    D3D11CreateDevice = geecore_D3D11CreateDevice
    D3D11CreateDeviceAndSwapChain = geecore_D3D11CreateDeviceAndSwapChain
    D3D11CreateDeviceForD3D12 = geecore_D3D11CreateDeviceForD3D12
    D3D11On12CreateDevice = geecore_D3D11On12CreateDevice
    D3DKMTCloseAdapter = geecore_D3DKMTCloseAdapter
    D3DKMTCreateAllocation = geecore_D3DKMTCreateAllocation
    D3DKMTCreateContext = geecore_D3DKMTCreateContext
    D3DKMTCreateDevice = geecore_D3DKMTCreateDevice
    D3DKMTCreateSynchronizationObject = geecore_D3DKMTCreateSynchronizationObject
    D3DKMTDestroyAllocation = geecore_D3DKMTDestroyAllocation
    D3DKMTDestroyContext = geecore_D3DKMTDestroyContext
    D3DKMTDestroyDevice = geecore_D3DKMTDestroyDevice
    D3DKMTDestroySynchronizationObject = geecore_D3DKMTDestroySynchronizationObject
    D3DKMTEscape = geecore_D3DKMTEscape
    D3DKMTGetContextSchedulingPriority = geecore_D3DKMTGetContextSchedulingPriority
    D3DKMTGetDeviceState = geecore_D3DKMTGetDeviceState
    D3DKMTGetDisplayModeList = geecore_D3DKMTGetDisplayModeList
    D3DKMTGetMultisampleMethodList = geecore_D3DKMTGetMultisampleMethodList
    D3DKMTGetRuntimeData = geecore_D3DKMTGetRuntimeData
    D3DKMTGetSharedPrimaryHandle = geecore_D3DKMTGetSharedPrimaryHandle
    D3DKMTLock = geecore_D3DKMTLock
    D3DKMTOpenAdapterFromHdc = geecore_D3DKMTOpenAdapterFromHdc
    D3DKMTOpenResource = geecore_D3DKMTOpenResource
    D3DKMTPresent = geecore_D3DKMTPresent
    D3DKMTQueryAdapterInfo = geecore_D3DKMTQueryAdapterInfo
    D3DKMTQueryAllocationResidency = geecore_D3DKMTQueryAllocationResidency
    D3DKMTQueryResourceInfo = geecore_D3DKMTQueryResourceInfo
    D3DKMTRender = geecore_D3DKMTRender
    D3DKMTSetAllocationPriority = geecore_D3DKMTSetAllocationPriority
    D3DKMTSetContextSchedulingPriority = geecore_D3DKMTSetContextSchedulingPriority
    D3DKMTSetDisplayMode = geecore_D3DKMTSetDisplayMode
    D3DKMTSetDisplayPrivateDriverFormat = geecore_D3DKMTSetDisplayPrivateDriverFormat
    D3DKMTSetGammaRamp = geecore_D3DKMTSetGammaRamp
    D3DKMTSetVidPnSourceOwner = geecore_D3DKMTSetVidPnSourceOwner
    D3DKMTSignalSynchronizationObject = geecore_D3DKMTSignalSynchronizationObject
    D3DKMTUnlock = geecore_D3DKMTUnlock
    D3DKMTWaitForSynchronizationObject = geecore_D3DKMTWaitForSynchronizationObject
    D3DKMTWaitForVerticalBlankEvent = geecore_D3DKMTWaitForVerticalBlankEvent
    D3DPerformance_BeginEvent = geecore_D3DPerformance_BeginEvent
    D3DPerformance_EndEvent = geecore_D3DPerformance_EndEvent
    D3DPerformance_GetStatus = geecore_D3DPerformance_GetStatus
    D3DPerformance_SetMarker = geecore_D3DPerformance_SetMarker
    EnableFeatureLevelUpgrade = geecore_EnableFeatureLevelUpgrade
    OpenAdapter10 = geecore_OpenAdapter10
    OpenAdapter10_2 = geecore_OpenAdapter10_2

    ApplyCompatResolutionQuirking = geecore_ApplyCompatResolutionQuirking
    CompatString = geecore_CompatString
    CompatValue = geecore_CompatValue
    CreateDXGIFactory = geecore_CreateDXGIFactory
    CreateDXGIFactory1 = geecore_CreateDXGIFactory1
    CreateDXGIFactory2 = geecore_CreateDXGIFactory2
    DXGID3D10CreateDevice = geecore_DXGID3D10CreateDevice
    DXGID3D10CreateLayeredDevice = geecore_DXGID3D10CreateLayeredDevice
    DXGID3D10GetLayeredDeviceSize = geecore_DXGID3D10GetLayeredDeviceSize
    DXGID3D10RegisterLayers = geecore_DXGID3D10RegisterLayers
    DXGIDeclareAdapterRemovalSupport = geecore_DXGIDeclareAdapterRemovalSupport
    DXGIDumpJournal = geecore_DXGIDumpJournal
    DXGIGetDebugInterface1 = geecore_DXGIGetDebugInterface1
    DXGIReportAdapterConfiguration = geecore_DXGIReportAdapterConfiguration
    PIXBeginCapture = geecore_PIXBeginCapture
    PIXEndCapture = geecore_PIXEndCapture
    PIXGetCaptureState = geecore_PIXGetCaptureState
    SetAppCompatStringPointer = geecore_SetAppCompatStringPointer
    UpdateHMDEmulationStatus = geecore_UpdateHMDEmulationStatus

    GetFileVersionInfoA = geecore_GetFileVersionInfoA
    GetFileVersionInfoByHandle = geecore_GetFileVersionInfoByHandle
    GetFileVersionInfoExA = geecore_GetFileVersionInfoExA
    GetFileVersionInfoExW = geecore_GetFileVersionInfoExW
    GetFileVersionInfoSizeA = geecore_GetFileVersionInfoSizeA
    GetFileVersionInfoSizeExA = geecore_GetFileVersionInfoSizeExA
    GetFileVersionInfoSizeExW = geecore_GetFileVersionInfoSizeExW
    GetFileVersionInfoSizeW = geecore_GetFileVersionInfoSizeW
    GetFileVersionInfoW = geecore_GetFileVersionInfoW
    VerFindFileA = geecore_VerFindFileA
    VerFindFileW = geecore_VerFindFileW
    VerInstallFileA = geecore_VerInstallFileA
    VerInstallFileW = geecore_VerInstallFileW
    VerLanguageNameA = geecore_VerLanguageNameA
    VerLanguageNameW = geecore_VerLanguageNameW
    VerQueryValueA = geecore_VerQueryValueA
    VerQueryValueW = geecore_VerQueryValueW

    CloseDriver = geecore_CloseDriver
    DefDriverProc = geecore_DefDriverProc
    DriverCallback = geecore_DriverCallback
    DrvGetModuleHandle = geecore_DrvGetModuleHandle
    GetDriverModuleHandle = geecore_GetDriverModuleHandle
    OpenDriver = geecore_OpenDriver
    PlaySound = geecore_PlaySound
    PlaySoundA = geecore_PlaySoundA
    PlaySoundW = geecore_PlaySoundW
    SendDriverMessage = geecore_SendDriverMessage
    WOWAppExit = geecore_WOWAppExit
    auxGetDevCapsA = geecore_auxGetDevCapsA
    auxGetDevCapsW = geecore_auxGetDevCapsW
    auxGetNumDevs = geecore_auxGetNumDevs
    auxGetVolume = geecore_auxGetVolume
    auxOutMessage = geecore_auxOutMessage
    auxSetVolume = geecore_auxSetVolume
    joyConfigChanged = geecore_joyConfigChanged
    joyGetDevCapsA = geecore_joyGetDevCapsA
    joyGetDevCapsW = geecore_joyGetDevCapsW
    joyGetNumDevs = geecore_joyGetNumDevs
    joyGetPos = geecore_joyGetPos
    joyGetPosEx = geecore_joyGetPosEx
    joyGetThreshold = geecore_joyGetThreshold
    joyReleaseCapture = geecore_joyReleaseCapture
    joySetCapture = geecore_joySetCapture
    joySetThreshold = geecore_joySetThreshold
    mciDriverNotify = geecore_mciDriverNotify
    mciDriverYield = geecore_mciDriverYield
    mciExecute = geecore_mciExecute
    mciFreeCommandResource = geecore_mciFreeCommandResource
    mciGetCreatorTask = geecore_mciGetCreatorTask
    mciGetDeviceIDA = geecore_mciGetDeviceIDA
    mciGetDeviceIDFromElementIDA = geecore_mciGetDeviceIDFromElementIDA
    mciGetDeviceIDFromElementIDW = geecore_mciGetDeviceIDFromElementIDW
    mciGetDeviceIDW = geecore_mciGetDeviceIDW
    mciGetDriverData = geecore_mciGetDriverData
    mciGetErrorStringA = geecore_mciGetErrorStringA
    mciGetErrorStringW = geecore_mciGetErrorStringW
    mciGetYieldProc = geecore_mciGetYieldProc
    mciLoadCommandResource = geecore_mciLoadCommandResource
    mciSendCommandA = geecore_mciSendCommandA
    mciSendCommandW = geecore_mciSendCommandW
    mciSendStringA = geecore_mciSendStringA
    mciSendStringW = geecore_mciSendStringW
    mciSetDriverData = geecore_mciSetDriverData
    mciSetYieldProc = geecore_mciSetYieldProc
    midiConnect = geecore_midiConnect
    midiDisconnect = geecore_midiDisconnect
    midiInAddBuffer = geecore_midiInAddBuffer
    midiInClose = geecore_midiInClose
    midiInGetDevCapsA = geecore_midiInGetDevCapsA
    midiInGetDevCapsW = geecore_midiInGetDevCapsW
    midiInGetErrorTextA = geecore_midiInGetErrorTextA
    midiInGetErrorTextW = geecore_midiInGetErrorTextW
    midiInGetID = geecore_midiInGetID
    midiInGetNumDevs = geecore_midiInGetNumDevs
    midiInMessage = geecore_midiInMessage
    midiInOpen = geecore_midiInOpen
    midiInPrepareHeader = geecore_midiInPrepareHeader
    midiInReset = geecore_midiInReset
    midiInStart = geecore_midiInStart
    midiInStop = geecore_midiInStop
    midiInUnprepareHeader = geecore_midiInUnprepareHeader
    midiOutCacheDrumPatches = geecore_midiOutCacheDrumPatches
    midiOutCachePatches = geecore_midiOutCachePatches
    midiOutClose = geecore_midiOutClose
    midiOutGetDevCapsA = geecore_midiOutGetDevCapsA
    midiOutGetDevCapsW = geecore_midiOutGetDevCapsW
    midiOutGetErrorTextA = geecore_midiOutGetErrorTextA
    midiOutGetErrorTextW = geecore_midiOutGetErrorTextW
    midiOutGetID = geecore_midiOutGetID
    midiOutGetNumDevs = geecore_midiOutGetNumDevs
    midiOutGetVolume = geecore_midiOutGetVolume
    midiOutLongMsg = geecore_midiOutLongMsg
    midiOutMessage = geecore_midiOutMessage
    midiOutOpen = geecore_midiOutOpen
    midiOutPrepareHeader = geecore_midiOutPrepareHeader
    midiOutReset = geecore_midiOutReset
    midiOutSetVolume = geecore_midiOutSetVolume
    midiOutShortMsg = geecore_midiOutShortMsg
    midiOutUnprepareHeader = geecore_midiOutUnprepareHeader
    midiStreamClose = geecore_midiStreamClose
    midiStreamOpen = geecore_midiStreamOpen
    midiStreamOut = geecore_midiStreamOut
    midiStreamPause = geecore_midiStreamPause
    midiStreamPosition = geecore_midiStreamPosition
    midiStreamProperty = geecore_midiStreamProperty
    midiStreamRestart = geecore_midiStreamRestart
    midiStreamStop = geecore_midiStreamStop
    mixerClose = geecore_mixerClose
    mixerGetControlDetailsA = geecore_mixerGetControlDetailsA
    mixerGetControlDetailsW = geecore_mixerGetControlDetailsW
    mixerGetDevCapsA = geecore_mixerGetDevCapsA
    mixerGetDevCapsW = geecore_mixerGetDevCapsW
    mixerGetID = geecore_mixerGetID
    mixerGetLineControlsA = geecore_mixerGetLineControlsA
    mixerGetLineControlsW = geecore_mixerGetLineControlsW
    mixerGetLineInfoA = geecore_mixerGetLineInfoA
    mixerGetLineInfoW = geecore_mixerGetLineInfoW
    mixerGetNumDevs = geecore_mixerGetNumDevs
    mixerMessage = geecore_mixerMessage
    mixerOpen = geecore_mixerOpen
    mixerSetControlDetails = geecore_mixerSetControlDetails
    mmDrvInstall = geecore_mmDrvInstall
    mmGetCurrentTask = geecore_mmGetCurrentTask
    mmTaskBlock = geecore_mmTaskBlock
    mmTaskCreate = geecore_mmTaskCreate
    mmTaskSignal = geecore_mmTaskSignal
    mmTaskYield = geecore_mmTaskYield
    mmioAdvance = geecore_mmioAdvance
    mmioAscend = geecore_mmioAscend
    mmioClose = geecore_mmioClose
    mmioCreateChunk = geecore_mmioCreateChunk
    mmioDescend = geecore_mmioDescend
    mmioFlush = geecore_mmioFlush
    mmioGetInfo = geecore_mmioGetInfo
    mmioInstallIOProcA = geecore_mmioInstallIOProcA
    mmioInstallIOProcW = geecore_mmioInstallIOProcW
    mmioOpenA = geecore_mmioOpenA
    mmioOpenW = geecore_mmioOpenW
    mmioRead = geecore_mmioRead
    mmioRenameA = geecore_mmioRenameA
    mmioRenameW = geecore_mmioRenameW
    mmioSeek = geecore_mmioSeek
    mmioSendMessage = geecore_mmioSendMessage
    mmioSetBuffer = geecore_mmioSetBuffer
    mmioSetInfo = geecore_mmioSetInfo
    mmioStringToFOURCCA = geecore_mmioStringToFOURCCA
    mmioStringToFOURCCW = geecore_mmioStringToFOURCCW
    mmioWrite = geecore_mmioWrite
    mmsystemGetVersion = geecore_mmsystemGetVersion
    sndPlaySoundA = geecore_sndPlaySoundA
    sndPlaySoundW = geecore_sndPlaySoundW
    timeBeginPeriod = geecore_timeBeginPeriod
    timeEndPeriod = geecore_timeEndPeriod
    timeGetDevCaps = geecore_timeGetDevCaps
    timeGetSystemTime = geecore_timeGetSystemTime
    timeGetTime = geecore_timeGetTime
    timeKillEvent = geecore_timeKillEvent
    timeSetEvent = geecore_timeSetEvent
    waveInAddBuffer = geecore_waveInAddBuffer
    waveInClose = geecore_waveInClose
    waveInGetDevCapsA = geecore_waveInGetDevCapsA
    waveInGetDevCapsW = geecore_waveInGetDevCapsW
    waveInGetErrorTextA = geecore_waveInGetErrorTextA
    waveInGetErrorTextW = geecore_waveInGetErrorTextW
    waveInGetID = geecore_waveInGetID
    waveInGetNumDevs = geecore_waveInGetNumDevs
    waveInGetPosition = geecore_waveInGetPosition
    waveInMessage = geecore_waveInMessage
    waveInOpen = geecore_waveInOpen
    waveInPrepareHeader = geecore_waveInPrepareHeader
    waveInReset = geecore_waveInReset
    waveInStart = geecore_waveInStart
    waveInStop = geecore_waveInStop
    waveInUnprepareHeader = geecore_waveInUnprepareHeader
    waveOutBreakLoop = geecore_waveOutBreakLoop
    waveOutClose = geecore_waveOutClose
    waveOutGetDevCapsA = geecore_waveOutGetDevCapsA
    waveOutGetDevCapsW = geecore_waveOutGetDevCapsW
    waveOutGetErrorTextA = geecore_waveOutGetErrorTextA
    waveOutGetErrorTextW = geecore_waveOutGetErrorTextW
    waveOutGetID = geecore_waveOutGetID
    waveOutGetNumDevs = geecore_waveOutGetNumDevs
    waveOutGetPitch = geecore_waveOutGetPitch
    waveOutGetPlaybackRate = geecore_waveOutGetPlaybackRate
    waveOutGetPosition = geecore_waveOutGetPosition
    waveOutGetVolume = geecore_waveOutGetVolume
    waveOutMessage = geecore_waveOutMessage
    waveOutOpen = geecore_waveOutOpen
    waveOutPause = geecore_waveOutPause
    waveOutPrepareHeader = geecore_waveOutPrepareHeader
    waveOutReset = geecore_waveOutReset
    waveOutRestart = geecore_waveOutRestart
    waveOutSetPitch = geecore_waveOutSetPitch
    waveOutSetPlaybackRate = geecore_waveOutSetPlaybackRate
    waveOutSetVolume = geecore_waveOutSetVolume
    waveOutUnprepareHeader = geecore_waveOutUnprepareHeader
    waveOutWrite = geecore_waveOutWrite
    PlaySoundStub = geecore_PlaySoundStub
